{
	"tileset" : "tiles-map.png",
	"terrain" : [
		[53, 12, 4 , 5 , 12, 12, 12, 12, 12,  4 , 5 ,  12,  12,  12,  12, 12, 12, 12, 12, 12, 4, 5, 6, 7, 12,  12,  12,  12,  12, 4,  5,  12,  12,  12, 12, 12, 12, 3],

		[3, 12, 19, 20, 12, 12, 12, 12, 12,  19, 20,  12,  12,  12,  12, 12, 12, 12, 12, 12, 19, 20, 21, 22, 12,  12,  12,  12,  12, 19,  20,  12,  12,  12, 12, 12, 12, 3],

		[53, 12, 34, 35, 12, 12, 12, 12, 12,  34, 35,  12,  12,  12,  12, 12, 12, 12, 12, 12, 34, 35, 36, 37, 12,  12,  12,  12,  12, 34,  35,  12,  12,  12, 12, 12, 12, 3],

		[3, 12, 12, 12, 12, 11, 8, 8, 8,  8,  8,  8,  8,  8,  8, 8, 8, 8, 8, 8, 8, 8, 8, 8, 8,  8,  8,  8,  8, 12,  12,  12,  12,  12, 12, 12, 12, 3],

		[53, 12, 12, 12, 12, 3, 12, 38, 38,  38,  38,  38,  38,  38,  38, 38, 38, 38, 38, 38, 38, 38, 38, 38, 12,  12,  12,  12,  12, 12,  12,  12,  12,  12, 12, 12, 12, 3],

		[3, 12, 12, 12, 12, 18, 12, 53, 53,  53,  53,  53,  53,  53,  53, 53, 53, 53, 53, 53, 53, 53, 53, 53, 12,  12,  12,  12,  56, 57,  57,  57,  57,  57, 57, 58, 12, 3],

		[3, 12, 12, 12, 12, 33, 12, 3, 3,  3,  3,  3,  3,  3,  3, 3, 3, 3, 3, 3, 3, 3, 3, 3, 12,  12,  12,  12,  71, 12,  12,  12,  12,  12, 12, 71, 12, 3],

		[3, 12, 12, 12, 12, 38, 38, 38, 38,  38,  38,  38,  38,  38,  38, 38, 38, 38, 38, 38, 38, 38, 38, 38, 38,  12,  12,  12,  71, 12,  4, 5, 6, 7, 12, 71, 12, 3],

		[53, 12, 12, 12, 12, 53, 53, 53, 53,  53,  53,  53,  53,  53,  53, 53, 53, 53, 53, 53, 53, 53, 53, 53, 53,  12,  12,  12,  71, 12,  19, 20, 21, 22, 12, 71, 12, 3],

		[3, 12, 12, 12, 12, 3, 3, 3, 3,  3,  3,  3,  3,  3,  3, 3, 3, 3, 3, 3, 3, 3, 3, 3, 3,  12,  12,  12,  71, 12,  34, 35, 36, 37, 12, 71, 12, 3],

		[53, 12, 12, 12, 12, 53, 53, 53, 53,  53,  53,  53,  53,  53,  53, 53, 53, 53, 53, 53, 53, 53, 53, 53, 53,  12,  12,  12,  71, 12,  12,  12,  12,  12, 12, 71, 12, 3],

		[3, 12, 12, 12, 12, 3, 3, 3, 3,  3,  3,  3,  3,  3,  3, 3, 3, 3, 3, 3, 3, 3, 3, 3, 3,  12,  12,  12,  82, 83,  83,  83,  83,  83, 83, 84, 12, 3],

		[53, 12, 12, 12, 12, 12, 53, 53, 53,  53,  53,  53,  53,  53,  53, 53, 53, 53, 53, 53, 53, 53, 53, 53, 68,  12,  12,  12,  12, 12,  12,  12,  12,  12, 12, 12, 12, 3],

		[3, 12, 12, 12, 12, 12, 3, 3, 3,  3,  3,  3,  68,  68,  68, 68, 68, 68, 68, 68, 68, 68, 68, 68, 12,  12,  12,  12,  12, 12,  12,  12,  12,  12, 12, 12, 12, 3],

		[3, 12, 12, 12, 12, 12, 12, 3, 3,  53,  53,  53,  12,  12,  12, 12, 12, 12, 12, 12, 12, 12, 12, 12, 12,  12,  12,  12,  12, 12,  12,  12,  12,  12, 12, 12, 12, 3],

		[3, 12, 12, 12, 12, 12, 12, 3, 3,  68,  68,  68,  12,  12,  12, 12, 12, 12, 12, 12, 12, 12, 12, 12, 12,  12,  12,  12,  12, 12,  12,  12,  12,  12, 12, 12, 12, 3],

		[53, 12, 12, 12, 12, 12, 12, 53, 53,  12,  12,  12,  12,  12,  12, 12, 64, 17, 17, 17, 31, 17, 65, 12, 12,  12,  12,  12,  61, 62,  12,  12,  12,  12, 12, 12, 12, 3],

		[3, 12, 12, 12, 12, 12, 12, 68, 68,  12,  12,  64,  31,  31,  31, 31, 79, 32, 32, 32, 12, 32, 63, 12, 12,  12,  12,  12,  76, 77,  12,  12,  12,  12, 12, 12, 12, 3],

		[53, 12, 12, 12, 12, 12, 12, 12, 12,  12,  12,  63,  12,  12,  12, 12, 12, 12, 12, 12, 12, 12, 80, 31, 31,  65,  12,  12,  12, 12,  12,  12,  12,  12, 12, 12, 12, 3]
	]
}
